[{
  "layout":[
    ["-", "-", "-", "O", "-", "-", "-", "-", "-", "O"], 
    ["-", "O", "-", "-", "-", "O", "-", "D", "-", "-"], 
    ["-", "-", "-", "-", "O", "-", "-", "O", "-", "-"], 
    ["-", "O", "-", "O", "-", "-", "-", "-", "-", "-"], 
    ["-", "-", "-", "-", "-", "O", "-", "O", "-", "-"], 
    ["F", "-", "-", "O", "-", "-", "-", "-", "-", "O"], 
    ["-", "-", "O", "-", "-", "-", "-", "-", "-", "-"], 
    ["-", "-", "-", "-", "-", "-", "-", "O", "-", "-"], 
    ["-", "O", "-", "-", "O", "O", "-", "-", "-", "-"], 
    ["-", "-", "-", "-", "-", "-", "-", "-", "O", "-"]
  ],
  "index": 0
},
{
  "layout":[
    ["-", "-", "-", "O", "-", "-", "-", "-", "-", "O"], 
    ["-", "O", "-", "-", "-", "O", "-", "-", "-", "-"], 
    ["-", "-", "-", "-", "O", "-", "-", "O", "-", "-"], 
    ["D", "O", "-", "O", "-", "-", "-", "-", "-", "-"], 
    ["-", "-", "-", "-", "-", "O", "-", "O", "-", "-"], 
    ["F", "-", "-", "O", "-", "-", "-", "-", "-", "O"], 
    ["-", "-", "O", "-", "-", "-", "-", "-", "-", "-"], 
    ["-", "-", "-", "-", "-", "-", "-", "O", "-", "-"], 
    ["-", "O", "-", "-", "O", "O", "-", "-", "-", "-"], 
    ["-", "-", "-", "-", "-", "-", "-", "-", "O", "-"]
  ],
  "index": 1
}]